77777777777777777
90000000000000008
90101010101010108
90202020202020208
90303030303030308
90404040404040408
90505050505050508
90606060606060608
90707070707070708
90808080808080808
90909090909090908
90000000000000008
90101010101010108
90000000000000008
66666666666666666